11111111111111111111
10000C00000000C00111
10000000P00000000C11
10000000000000000E01
100000000C00C00000C1
11111111111111111111