11111111111111111111
10000C00C000000C0001
10000000P00000000001
10000000100000000001
10000000E100000C0011
11111111111111111111