11111111111111111111
10000000000000010001
10000C00010000000011
10000000P000E0C000C1
10000001000001010011
11111111111111111111