11111111111111111111
10000000000000000001
10000000P00000000001
10000000000000000011
100000000000C0000EC1
11111111111111111111